                                      
                                      
                                      
                                      
                                                NO              ./assets/image/NO.png       



                                                                             
                                                                              
                         SO                                    assets/image/SO.png                                                                             
          
          
          
           EA                         assets/image/EA.png                                      
                               
                               
                                WE                    assets/image/WE.png                              

 F                                                                                6              , 125  ,       28
				
                                
                                
                                 C        130                                                           ,       200                            ,        229


        1111111111111111111111111
        1000000000110000000000001
        1011000001110000000000001
        1001000000000000000000001
111111111D1100D1D1110000000000001
100000000011010011110111111111111
111101111111D1DD1100000010001111111111111111111111111111111111111111111111111111111111111111111111111111111111111111111111111111111111111111111111111111111111111111111111111111111111111111111111111111111111111111111111111111111111111111111111111111111111111111111111111111111111111111111111111111111111111111111111111111111111111111111111111111
11110111111111011101010011001111111111111111111111111111111111111111111111111111111111111111111111111111111111111111111111111111111111111111111111111111111111111111111111111111111111111111111111111111111111111111111111111111111111111111111111111111111111111111111111111111111111111111111111111111111111111111111111111111111111111111111111111111
11000000110101011100000010001
10000000000000001100000000001
10000000000000001101010000001
10000011101010111110111100011
11110111 1110101 1011110000E1
11111111 1111111 111111111111









 
  
  
