                                                NO              assets/image/ice.png                                     
                         SO                                    ./path_to_the_south_texture
           EA                         ./path_to_the_east_texture
                                WE                    ./path_to_the_west_texture

 F                                                                                6              , 125  ,       28
				 C        130                                                           ,       200                            ,        229

        1111111111111111111111111
        1000000000110000000000001
        1011000001110000000000001
        1001000000000000000000001
111111111011000001110000000000001
100000000011000001110111111111111
11110111111111011100000010001
11110111111111011101010011001
11000000110101011100000010001
10000000000000001100000000001
10000000000000001101010000001
1000001110101011111011110S011
11110111 1110101 101111000001
11111111 1111111 111111111111
