C 130,200,229


SO ./assets/image/SO.png

EA ./assets/image/EA.png

WE ./assets/image/WE.png

NO assets/image/NO.png



F 255, 255, 255



111111111111
100000000001
100000000001
100000000001
100000000001
100000000001
10000100W001
100000000001
100000000001
100000000001
111111111111
