F 255, 255, 255
NO assets/image/Wall.png
C 0,0,0
SO ./assets/image/Wall.png
WE ./assets/image/Wall.png
EA ./assets/image/Wall.png



                
111111111111
100000000001
100001000101
100001000101
100001000101
100000000101
10000100W101
111111111101
111111111101
100000000001
111111111111