F 6, 125, 28
NO ./textures/wall2.xpm
C 130,200,229
SO ./textures/wall2.xpm
WE ./textures/wall1.xpm
EA ./textures/wall2.xpm




111111111101
100000000101
100001000101
100001000101
100001000101
100000000101
10000100W101
111111111101
111111111101
100000000001
111111111101