NO assets/image/wall_horror3.png
SO ./assets/image/wall_horror3.png
WE ./assets/image/wall_horror3.png
EA ./assets/image/wall_horror3.png

C 0,0,0
F 255, 255, 255

                
111111111111111
111111000111111
111110000011111
1111000N0001111
111000000000111
110000000000011
100001111100001
110D0011100D011
111000010000111
111100000001111
111110000011111
111111000111111
111111111111111
